{
    "player_start": {
        "pos":{
            "x": 128,
            "y": 210
        }
    },
    "levels": {
        "0":[
            ["N", "N", "N", "D", "N", "N", "D", "N", "N", "N"],
            ["N", "N", "C", "C", "C", "C", "C", "C", "N", "N"],
            ["N", "B", "B", "B", "B", "B", "B", "B", "B", "N"],
            ["A", "A", "A", "A", "A", "A", "A", "A", "A", "A"],
            ["A", "A", "A", "A", "A", "A", "A", "A", "A", "A"],
            ["A", "A", "A", "A", "A", "A", "A", "A", "A", "A"]
        ],
        "1":[
            ["B", "C", "N", "D", "N", "N", "D", "N", "C", "B"],
            ["A", "B", "C", "N", "D", "D", "N", "C", "B", "A"],
            ["N", "A", "B", "C", "N", "N", "C", "B", "A", "N"],
            ["N", "N", "A", "B", "C", "C", "B", "A", "N", "N"],
            ["N", "N", "N", "A", "B", "B", "A", "N", "N", "N"],
            ["A", "A", "N", "N", "A", "A", "N", "N", "A", "A"]
        ],
        "2":[
            ["A", "N", "N", "B", "D", "N", "N", "C", "A", "N"],
            ["N", "A", "B", "N", "N", "D", "C", "N", "N", "A"],
            ["A", "N", "N", "B", "D", "N", "N", "C", "A", "N"],
            ["N", "A", "B", "N", "N", "D", "C", "N", "N", "A"],
            ["A", "N", "N", "B", "D", "N", "N", "C", "A", "N"],
            ["N", "A", "B", "N", "N", "D", "C", "N", "N", "A"]
        ],
        "3":[
            ["A", "B", "C", "D", "D", "D", "D", "C", "B", "A"],
            ["A", "B", "C", "D", "D", "D", "D", "C", "B", "A"],
            ["A", "B", "C", "D", "D", "D", "D", "C", "B", "A"],
            ["A", "B", "C", "D", "D", "D", "D", "C", "B", "A"],
            ["A", "A", "A", "A", "A", "A", "A", "A", "A", "A"],
            ["A", "A", "A", "A", "A", "A", "A", "A", "A", "A"]
        ],
        "4":[
            ["N", "D", "N", "D", "N", "D", "N", "D", "N", "D"],
            ["D", "N", "D", "N", "D", "N", "D", "N", "D", "N"],
            ["N", "D", "N", "D", "N", "D", "N", "D", "N", "D"],
            ["D", "N", "D", "N", "D", "N", "D", "N", "D", "N"],
            ["N", "D", "N", "D", "N", "D", "N", "D", "N", "D"],
            ["D", "N", "D", "N", "D", "N", "D", "N", "D", "N"]
        ]
    }
}